##############################################################################################################################################################################################################################
##########                                                                  ##########                                                                  ##########
  ######                                                                      ######                                                                      ######
    ##                                                                          ##                                                                          ##














    ##                                                                                           ##                                                                                 ##
  ######                                                                                       ######                                                                             ######
##########                                                                                   ##########                                                                         ##########
##############################################################################################################################################################################################################################